.######################################################################################################################################################
......#.........#.....#.......#...#.........#.....#.....#.........#.................#...#.............#.......#.......#...........#.............#.....#
#####.#####.###.#####.#.###.#.###.#.#####.#.###.###.###.#.#####.###.#########.#####.#.#.###.#####.###.###.###.###.###.###.#####.###.#.#########.#.###.#
#...#.#.....#.#.....#.....#.#...#.#...#.#.#.#...#...#...#.#.#...#.......#.....#.......#...#.....#.#.......#.#.....#.#...#.#...#.....#.#.#.......#.#...#
#.###.#.#####.#####.#######.###.#.###.#.#.#.#.###.###.#.#.#.#.###.#######.#####.#########.#######.#.#######.#######.###.###.#.#######.#.#.#######.#.###
#.....#.#.#.......#...#...#.#.#...#.#...#.#...#...#...#.#...#.....#.#.....#.......#.....#.......#.#.#...#.#...........#...#.#...#.....#.#...#.....#.#.#
#.#####.#.#.#.#######.#.#.#.#.###.#.###.#.#####.###.#######.#######.#.###.#######.#.###.#######.#.###.#.#.#.###.#####.###.#.###.#.#####.###.#.#####.#.#
#...#...#.#.#.......#...#.#.#.....#...#.#.#.......#...#...#.#...#...#...#.#.....#.#.#...#...#.....#...#.#...#.#.#...#.#.#...#...#.....#.....#.....#...#
###.###.#.#.#######.#####.#.###.###.###.#.#.#########.#.#.#.#.#.###.###.#.#.###.#.#.#.###.###.#####.###.#.###.#.#.#.#.#.#####.#######.#.#########.###.#
#.#.....#...#.....#...#...#...#...#.#...#.#.....#...#.#.#.#...#.#.....#.#.#...#.#.#.#.#.#.....#.....#...#.....#.#.#...#...#...#.......#.....#...#.#...#
#.#######.###.#.#####.#.#####.###.#.#.###.#####.#.#.#.#.#.#####.#.###.#.#####.#.###.#.#.#.#####.#####.#########.#.#####.###.###.###########.#.#.#.###.#
#.......#...#.#...#...#...#...#.....#.#.#.#.....#.#...#.#.....#...#.#.#.......#.....#.#.....#...#.....#.......#.#...#.....#.....#.....#...#...#.#...#.#
#######.###.#####.#.#####.#.#########.#.#.#.#####.#.###.#####.#####.#.###############.#####.#.###.#####.#####.#.###.#####.#######.#.#.#.#.#####.###.###
#.........#.#.....#.....#.#...........#.#...#.#...#.#...#.....#.......#.............#.#...#.#...#.....#...#...#.#.......#...#.....#.#...#.#...#...#...#
#.#######.#.#.###.###.#.#.###.#########.#####.#.###.#.###.#####.#######.#########.###.#.#.#####.#####.###.#.###.#######.#.###.#####.#####.#.#.###.###.#
#.#.......#...#.....#.#.#...#.................#...#.#...#...#...#.......#.......#.#...#.#.#.........#.....#.#.....#...#.#.......#...#...#.#.#...#...#.#
#.#####.#######.#####.#####.#############.#######.#####.###.#.###.#########.#####.#.###.#.#.###############.#####.#.###.#.#######.###.###.###.#####.#.#
#.....#.#.....#.#.....#...#.......#.....#.#.....#.....#...#...#.............#.....#.#...#...#.............#.....#.#.#...#...#...#...#.........#...#.#.#
#.###.###.###.#.#.#####.#.#######.#.###.#.#.###.###.#####.#######.###########.#.###.#.#######.###########.#####.#.#.#.#######.#.#.#.#.#########.#.#.#.#
#...#...#.#...#.#.....#.#.#.......#.#.#.#.#...#...#.....#.#.....#.#...........#.#...#.#.....#.#...#.....#.......#.#...#.......#.#.#.#.#.......#.#...#.#
###.###.#.#.###.#####.#.#.#.#######.#.#.#####.###.###.#.#.#.###.###.#########.###.#.#.#.###.#.#.###.#.###########.#.#####.#####.###.###.#####.#.#####.#
#...#...#.#.....#...#.#.#...#.......#.#...#...#.#...#.#.#...#.#...#.#.....#...#...#.#.#.#...#.#.....#.....#.......#.....#.....#.#...#...#.#...#...#...#
#.###.#.#.#########.#.#.#####.#####.#.###.#.###.###.#.#.#####.###.#.#.###.#####.#####.#.#####.#.#######.###.#.#########.#####.#.#.#.#.###.#.#####.#.#.#
#.#...#.#.#.....#...#...#...#.#.....#...#...#.#.....#.#.........#.#.#.#.......#.........#...#.#.......#.....#.........#.......#...#.#.....#.....#.#.#.#
#.#.#####.#.###.#.#.#####.#.#.#.#####.#.#####.#.#######.#########.#.#.#######.#.#########.#.#.###################.###.#########.#########.###.###.#.###
#.#...#...#...#...#...#...#...#.#.....#.......#.#.....#.............#...#...#.#...#.......#.#.#...........#.....#.#.#...#.....#.#.....#...#.#.....#...#
#.###.#.#####.#########.#######.#.#.###.#####.#.###.#.###.###########.#.#.#.#.#####.#######.#.#.#####.###.#.###.#.#.###.#####.#.#.###.#.###.#########.#
#.#.#.#.....#...........#.#.....#.#...#.#...#.#.....#...#...#.......#.#.#.#.........#.......#...#...#...#...#.#.#.....#.....#...#.#.#...#.............#
#.#.#.#####.###.#########.#.#####.###.###.#.###########.#####.#####.#.#.#####.#######.###########.#.#####.###.#.#####.#####.#####.#.#############.###.#
#.#.#.....#...#...#.......#...#.#.#.#.....#.....#.....#.......#...#.#.#.....#.#...#.#...#.........#.....#.....#.#.....#...#.....#.#.........#.....#...#
#.#.#.#######.###.#.#####.###.#.#.#.###########.#.#.###########.###.#.#####.###.#.#.###.#.###.#########.#######.#.#####.#.#####.#.#####.###.#.#####.###
#.#.#.........#.#.#.#.....#.#.#.....#...#.....#.#.#.#...........#...#.....#.....#.#...#.#...#.#.....#...#.....#.#.#.....#.....#.#.....#.#.#.#...#.#...#
#.#.###########.#.#.#.#####.#.#####.#.#.#.#.#.#.#.#.#.#######.###.#########.#####.###.#.#####.#.#.###.###.###.#.###.#########.#.#####.#.#.#.#.#.#.###.#
#.#.............#...#.#.....#.....#.#.#...#.#.#.#.#...#.......#...#...#...#.....#.#...#.......#.#.#...#...#...#...#.....#.........#...#.#...#.#.#.....#
#.#.#######.###.#####.#.#########.#.#######.###.#.#####.#####.#.###.#.#.#.#######.#.###########.#.#.###.###.#####.#.###.#.#########.###.#.#####.#######
#.#...#...#.#.#.......#...#.......#.......#...#.#.#.#...#...#.#.....#...#.........#.....#.....#.#.#.#.....#.......#...#.#.#.........#...#...#...#.....#
#.###.#.#.#.#.###########.#.#######.#####.###.#.#.#.#.#.#.#.#.#####################.#.#.#.###.#.#.#.###.#.###########.#.###.###########.###.#.###.###.#
#...#.#.#.#...............#.#...#...#...#...#.#.#.#.#.#.#.#.#.........#.......#.....#.#...#.#.#.#.#...#.#.#...........#.....#...........#.#.#.....#...#
###.###.#.#.#######.#######.#.#.###.#.#.###.#.#.#.#.#.###.#.#########.###.###.#.#####.#####.#.###.###.###.#.#################.###########.#.#.#####.###
#.#.#...#.#.#...#...#.......#.#...#.#.#.#.....#.#.#.#.....#...#.....#.....#...#.#...#.....#.#.....#.#.....#.#.............#...#.#...#.......#.....#...#
#.#.#.###.#.#.#.#.###.#######.###.###.#.#####.#.#.#.#########.#.###.#######.###.#.#.#####.#.#####.#.#######.#####.#######.#.#.#.#.#.#.#######.#######.#
#.#.#...#.#.#.#.#.#...#...#...#.#.....#.....#.#...#.......#...#.#.....#.#...#...#.#.....#.#.....#...#.....#.......#.....#.#.#.#...#.#.#.......#.......#
#.#.###.#.###.#.###.###.###.#.#.###########.#.#####.###.#.#.###.#####.#.#.###.#######.#.#.#.###.###.#.#.#.#########.#####.#.#.###.#.#.#####.###.#.#####
#...#...#.....#...#.#.......#.#.........#...#.#.......#.#.#.#.....#...#.#...#.#.......#.#.#...#.#...#.#.#.#.......#.......#.#...#.#.#.....#.#.#.#.#...#
#.###.###########.#.#########.#.###.#####.###.#########.#.#.###.#.#.###.###.#.#.#######.#.###.###.#####.#.#.#####.#.#######.###.###.#####.#.#.#.###.#.#
#.....#.......#.#...#.......#.#.#.#.#...#.#...#.......#.#.#...#.#.#...#...#.#...#...#...#.#...#.........#.#.#.....#.#.......#...#...#.#...#.#.#.#...#.#
#########.###.#.#####.#####.#.#.#.#.#.#.#.#.###.#####.#.#.###.#.#.###.###.#.#####.###.###.#.#.#.###########.#.###.#.#.#####.#.###.#.#.#.###.#.#.#.###.#
#.....#...#...#.....#.....#...#.#...#.#.#.#.....#...#...#.#...#.#...#.....#.#...#...#...#.#.#.#.#.#.........#.#...#.#.#...#.#.#...#.#.#...#...#.....#.#
#.###.#.###.###.###.#####.#####.#####.#.#.#######.###.#####.#######.#####.#.#.#.###.#.###.#.###.#.#.#########.#####.#.#.#.###.#.#.#.#.###.###########.#
#...#...#.......#.....#...#.....#.....#...#...#.......#...#.#.......#...#.#...#...#...#...#...#.#.#...#.....#.......#.#.#.....#.#.#.....#.#.......#...#
###.#.###############.#.#######.#.#########.#.#########.#.#.#.#.###.#.#.#########.#####.#####.#.#.###.#####.###########.#######.#.###.###.#.#####.#.#.#
#...#.#.........#...#...#.....#.#.......#...#.........#.#...#.#.#...#.#.........#.#...#.....#...#...#.............#...#.......#.#...#.#...#.#...#...#.#
#.#####.#######.#.#.#######.#.#.#######.#.###########.#.#######.###.#.###.#####.#.#.#.#####.#.###.#.#############.#.#.#.#####.#####.###.###.#.#.#####.#
#.#...#.#.....#.#.#...#.....#.#.....#.#...#...........#.#.....#...#.#...#.....#.#.#.#.....#.#.#...#.....#.......#.#.#.#.....#.....#.....#.....#.#...#.#
#.#.#.#.#.###.#.#.###.#.#####.#.###.#.#####.###########.#.###.###.#.###.#####.#.#.#.#####.#.#.#.#.#######.#.#####.#.#.###########.#.#####.#####.#.#.#.#
#...#.#...#.#.#.#...#.#.#...#.#...#.#.....#...#.........#...#.....#...#.....#.#.#...#...#.#.#.#.#.....#...#.......#.#.............#.#.#.....#...#.#.#.#
#.###.#####.#.#.###.#.#.###.#.###.#.###.#.###.#.###########.#########.#####.#.#.#######.#.#.#.#####.#.#.###########.###############.#.#.#####.#.#.#.###
#...#...#...#.#.#...#.#...#...#...#...#.#...#...#...........#.#.....#...#...#.#.....#...#...#.....#.#.#.#.#.....#...........#.......#.....#...#.#.#...#
###.###.#.#.#.#.#.###.###.###.#.#####.###.###########.#######.#.###.#.###.###.#####.#.###########.#.#.#.#.#.###.#.#########.###.#####.#####.#####.###.#
#...#...#.#...#.....#...#...#...#.......#.....#...#...#.#...#...#.#...#...#.#...#.#...#.........#.#.#.#.#.#.#.#...#.......#...#...#...#...#.#.....#.#.#
#.###.###.#######.#####.###.#####.#####.###.#.#.#.#.###.#.#.#.###.#####.###.###.#.###.#.#######.#.###.#.#.#.#.#####.###.#####.###.#.###.#.#.#.#####.#.#
#.#...#.....#...#.#.....#...#.....#...#.#...#...#.#...#...#...#...#.....#...#.#.#.....#.#.....#.......#.#.#.#.#...#.#.#.....#.#.#.#.#...#.#...#.....#.#
#.#.###.#####.#.###.#####.#.#####.#.#.#.#.#######.#.#.#######.#.###.#####.#.#.#.#.#####.#####.#########.#.#.#.#.#.#.#.#####.#.#.#.###.###.#.#####.#.#.#
#.#.....#.....#...#.#...#.#.#...#.#.#.#...#.....#.#.#...#...#...#...#.....#.#.#.#.....#.......#.....#...#...#...#...#...#...#.#.....#.#...#.....#.#.#.#
#.#######.#######.#.#.#.#.###.#.###.#.#.###.###.#.#####.#.#.#####.###.#####.#.#.#############.#.###.#.###.###.#####.#.#.#.###.#####.#.#.#######.###.#.#
#.#.#.....#.....#.#...#.#.#...#.....#.#.#.....#.#.....#.#.#...#...#.....#.....#...............#...#.#...#.#...#...#...#.#...#.....#...#.......#.....#.#
#.#.#.#####.###.#.###.#.#.#.#########.###.#####.#####.#.#.###.#.#####.#.#########################.#.###.#.#.###.#.#########.#####.###########.#.#####.#
#...#.........#.#...#.#.#...#.......#.....#...#.#.#...#.....#.#.....#.#.#.....#...#.........#...#.#.....#.#.#.#.#.....#.........#.#.........#.#.#.....#
###.###########.###.###.#.###.#.###.#######.#.#.#.#.#########.#####.###.#.###.#.#.#.#######.#.#.#.#######.#.#.#.#####.#.#####.###.#.#######.#.###.###.#
#.#.#.......#...#.....#.#.#.#.#...#...#.....#...#...#.........#...#.#...#.#.#...#.#.#.....#...#...#.#...#.#...#.....#.#...#...#...#.....#...#.....#...#
#.#.#.#####.#.#######.#.#.#.#.###.###.#.###########.###.#######.#.#.#.###.#.#####.#.#####.#########.#.#.#.#########.#.###.#####.#.#####.###########.###
#...#.#.....#.......#...#.#.#...#...#.#.......#...#...#.#.......#.....#...#.....#.#.....#.............#...#.....#...#.....#.....#.#...#...........#.#.#
#.#####.###########.#####.#.#.#####.#.#######.#.#.###.#.#.#############.#####.#.#.#####.###########.#######.###.#.#######.#.#######.#.#####.#####.#.#.#
#...#...#...#.......#...#.#.#.#.....#.#.....#...#.#.....#.#.....#.....#.#.....#.#.....#...........#.#.......#.#...#.....#.#.........#.....#...#...#...#
###.#.###.#.#.#######.###.#.#.#.#####.#.###.#####.###.###.#####.#.###.#.#.###########.###########.#.#.###.###.#########.#.###############.###.#.#####.#
#...#...#.#...#.....#.....#...#.#...#...#.#.#...#...#.#.........#...#.#.#...........#.....#.....#.#.#.#...#.............#...............#.#...#.#...#.#
#.#####.#.#####.#####.#####.###.#.#######.#.###.###.###.#########.###.#.#########.#.#####.#.###.#.#.###.###.###.#######.###.#####.#######.#.###.#.#.#.#
#.#.....#.#.....#.....#...#...#.#.#.......#.....#.#...#.#.#...#...#...#.........#.#.#...#.#.#...#.#.....#...#...#.......#...#...#.#.......#...#.#.#.#.#
#.#.###.#.###.#.#.#######.#.###.#.#.###.#.#####.#.###.#.#.#.#.#.###.###########.#.#.###.#.#.#.###.#######.###.#####.#####.###.#.###.#########.#.#.#.#.#
#...#.#.#...#.#.#.#.......#.#...#...#.#.#...#...#.#...#.#.#.#...#.#...........#.#.#...#.#...#.....#.....#.#.#.....#...#...#...#.#...#.......#.#...#...#
#####.#.###.#.###.#####.###.#.###.###.#.#.###.###.#.#.#.#.#.#####.#######.#####.#.###.#.#############.###.#.#####.###.#.###.###.#.###.#####.#.#########
#...#...#...#...#.....#...#.#...#.....#.#.#...#...#.#.#...#...#.........#.....#.#.#.#...#...........#...#.......#...#.#.#.#...#.#...#.#...#.#.#.......#
#.#.#.###.#####.#####.#.#.#.###.###.###.###.###.#.#.#####.###.#.#######.#####.#.#.#.#.###.#.#.#####.###.#######.###.###.#.###.#.###.#.#.#.#.#.#####.#.#
#.#.#.#.#.....#.......#.#.....#.#...#...#...#...#.#...#...#.#.#.....#.#.#...#...#.#...#...#.#.#...#...#...#.......#.........#.#.....#...#.#.#.....#.#.#
###.#.#.#####.#####.#########.#.###.#.###.###.#.#####.#.###.#.#.###.#.#.#.#.#####.#####.###.###.#.###.###.#.#######.#########.#.#########.#.#####.#.#.#
#...#.......#.....#.#.....#...#...#.#.#...#...#.....#...#...#.#...#.#.#.#.#.......#...#.#.#.....#.#.......#.#.#...#...#.......#.#.......#.#.#...#.#.#.#
#.#####.#########.#.#.###.#######.###.#.#####.#####.#####.###.#####.#.#.#.#######.#.#.#.#.#######.#######.#.#.#.#.#####.#########.###.###.#.#.#.#.###.#
#.......#.........#...#.........#...#.#.#...#.....#.....#...#.......#.#.#.#...#.#...#.#.#.......#.......#.#...#.#.......#.......#...#...#.#...#.#...#.#
#.#######.###########.#########.###.#.#.#.#.#########.#.###.#########.#.#.#.#.#.#####.#.#.#.#######.###.#####.#.#########.#####.###.###.#.#####.###.#.#
#.#.#...#.#...#...#...#.....#.......#.#...#...#.....#.#...#...#.......#.#.#.#.#.....#.#.#.#.#.....#.#...#.....#.........#...#.#.......#...#.....#.#.#.#
#.#.#.#.#.#.#.#.###.###.###.#########.#######.#.###.#.###.###.#.#.###.#.#.#.#.#.#####.#.#.#.#.###.###.#.#.#############.###.#.#############.#####.#.#.#
#.#.#.#...#.#.#.......#...#...#...#...#.........#.#...#...#...#.#...#.#.#...#.#.#...#.#.#.#.#...#.....#.#.#.........#.....#.#.#.............#.....#.#.#
#.#.#.###.#.#.#.#########.###.#.#.#.#.#.#########.#####.###.#.#.###.###.#####.#.#.#.#.#.###.###.###.#####.#.###.#####.#####.#.#.#.###############.#.#.#
#...#.#...#.#.#.#...#...#.#.#.#.#...#...#.....#.#.....#...#.#.#...#.....#...#...#.#...#.#.....#...#.#.....#...#...#...#.....#.#.#.#.....#.........#.#.#
#####.#####.#.###.#.#.#.#.#.#.#####.#####.###.#.#.#.#####.#.#.###.#######.#####.#.#.###.#.###.###.#.#.#####.#####.#.###.#####.#.###.###.###.#######.#.#
#.....#...#.#...#.#...#.#.#.#.....#.#...#...#.#...#.#.....#.#.#.#.....#.........#.#.#...#...#.#...#.#.#...#.#.....#.....#.....#.#...#.#...#...........#
#.#####.#.#.###.#.#####.#.#.#####.#.#.#.###.#.#####.#.#####.#.#.#####.#####.#####.###.###.#.###.###.#.#.###.#.###.#########.#.#.#.###.###.#.###########
#...#...#...#.#.#...#.#...#...#...#.#.#.....#.....#.....#...#.#.....#.....#.#...#...#.#...#...#...#.#.#.#...#.#.#.#.........#.#.#.#...#...#.#.........#
#.#.#.#######.#.###.#.#####.#.#.###.#.###########.#####.#.###.###.#######.#.#.#.#.#.#.#######.###.###.#.#.###.#.#.#.#####.#####.#.#.#.#.#.###.#######.#
#.#...#...#...#...#.#.......#.#.#...#.#...#...#...#...#...#.#...#.....#.#.#.#.#.#.#...#.........#.#...#...#...#...#.....#.#.....#.#.#.#.#.#...#.....#.#
#.#####.#.###.###.#.#.#######.#.#####.#.#.#.###.###.#.#####.###.###.#.#.#.###.#.#.#####.#.#######.#.#####.#.###.#########.#.###.#.#.#.#.###.###.###.#.#
#.......#...#.#...#.#...#.#...#.#...#...#.#...#.....#.#.#.........#.#...#.....#.#.....#.#.#.......#.#...#.#...#...#.....#.#.#...#.#.#.#...#.#...#...#.#
###########.#.#.###.###.#.#.###.#.#.#####.###.#######.#.#.#######.#.###########.#####.#.#.#.#######.#.#.#####.###.#.###.#.#.#.###.###.###.#.#####.###.#
#...#.....#...#...#.#...#.#...#...#.......#.....#...#.#...#.....#...#.........#...#.#...#.#.........#.#.......#.....#.....#.#...#.#.....#.#.#.....#...#
#.#.#.###.###.###.#.#.###.###.#############.###.#.#.#.#.###.###.#.###.#.###.#####.#.#####.###########.#####.#############.#.#####.#.###.#.#.#.###.#.#.#
#.#.....#.#...#...#.#.#.#.....#.........#...#.#.#.#...#.#...#.#.#.#...#.#...#.....#.....#...#...........#...#.........#...#.......#.#.#.#.....#.#.#.#.#
#.#######.#.###.#.#.#.#.#.#####.#######.#.###.#.#.#######.###.#.###.###.#####.#####.###.###.#####.#####.###.#.#######.#.###########.#.#.#######.#.#.#.#
#.#.......#...#.#.#...#...#.....#.#.....#.#.....#.......#.#...#.....#.#.......#.....#...#.#.....#.#...#...#.#.#...#.#.#.............#...#...#.....#.#.#
###.#####.###.#.#######.###.#####.#.#####.#.###########.#.###.#######.###############.#.#.#####.###.#.###.#.#.#.#.#.#.#######.###########.#.#######.#.#
#...#...#.#.#.#.#.....#.#...#.....#.......#.....#.....#.#...#.....#.............#...#.#.#.....#.....#.#...#.#...#...#...#.....#...........#.....#...#.#
#.###.###.#.#.#.#.###.#.###.#.###.#############.#.###.#.###.#.###.#.#####.#####.#.#.#.#.#.###.#######.#.#####.#########.###.###.###############.#.###.#
#...#...#...#.#...#.#...#...#...#...#.#.......#...#...#...#.#...#.#.#.#...#.....#.#.#.#...#.#.......#.#.#.....#.......#...#.#...#.#...........#.#...#.#
#.#.###.###.#.#####.#####.#####.#.#.#.#.#####.#####.###.#.#.###.#.#.#.#.###.#####.#.#.#####.#######.#.#.#.#####.#####.#.#.#.#.###.#.#.#########.###.#.#
#.#...#.....#.......#.........#.#.#.#...#.#...#...#...#.#.#...#.#.....#.#.#.#.....#.#.#.......#...#.#.#.....#...#.#...#.#.#.#...#.#.#...........#...#.#
#.###.#############.#.#######.#.#.#.#.###.#.###.#.###.#.#####.#########.#.#.#.#####.#.#######.#.#.#.#.#####.#.###.#.#####.#.###.#.#.#############.###.#
#.#.#...........#...#.....#...#.#.#.#.....#.#...#.....#.#...#.......#...#.#.#.#.#...#...#...#...#.#.#...#...#.#...#...#...#...#.#.#.#...#.......#...#.#
#.#.#######.#.#.#.#####.###.###.#.#.#####.#.#.#########.#.#.#######.#.###.#.#.#.#.###.#.#.#.#.###.#.###.#####.#.#####.#.#######.#.#.#.#.#.###.#.###.#.#
#.#.#.....#.#.#.#...#...#...#...#.#.....#.#.#.......#.#...#.......#...#...#.#.#.#.#...#...#.#...#...#.#.#...#.#.....#...#.......#.#...#.#.#.#.#.#...#.#
#.#.#.###.###.#####.#.###.###.###.#####.###.#######.#.#######.#########.#.#.#.#.#.#.#######.###.#####.#.#.#.#.###.#####.#.#######.#####.#.#.#.#.#.###.#
#...#...#.....#...#.#.#...#.#.#...#.......#.#.....#.....#...#...#.......#...#.#.#.#...#.....#.#.......#...#.#.#...#.....#.....#.#.....#.#...#.#...#.#.#
###.###.#####.#.#.#.###.###.#.#.#########.#.#.###.#####.#.#.###.#.###########.#.#.#####.#####.###.#########.#.#.###.#########.#.#.###.#.###.#.#####.#.#
#.#...#.....#.#.#.#.#...#.#...#.......#...#.....#...#.#...#.#...#.#.....#.....#.#.#.....#.......#.#.........#.#.....#.......#.#.#.#.#...#...#...#...#.#
#.###.#####.###.#.#.#.###.#.#########.#.#########.#.#.#####.#.###.#.###.#####.#.#.#.#####.#######.#.#########.#.#########.###.#.#.#.#####.#####.#.#.#.#
#...#.#...#.....#...#.#.#...#.#...#...#.....#.....#.......#.#...#...#.#...#...#.....#.............#.#.........#.#.......#...#.#.#.....#.......#.#.#...#
#.#.#.#.#############.#.#.###.#.#.#.#######.#.#############.###.#####.###.#.#######.###############.#.#####.###.#.#####.###.#.#.#####.#########.#.#####
#.#...#.........#.....#...#.#...#.#.#.....#.#.#.............#.#...........#.......#.#...........#...#.....#...#...#.........#.#.....#.#.......#.#.#...#
#.#####.#####.#.#####.#.###.#.###.#.###.#.#.#.#.#############.###############.###.###.#########.#.###########.#####.#########.#.###.#.#.#####.#.#.#.#.#
#.#.....#.....#...#...#...#...#...#...#.#.....#.#.........#.................#...#...#.....#...#...#.........#...#.#.#...#.....#...#.#.#.....#...#...#.#
#.#######.#######.#.#####.#.###.#.###.#.#######.#.#####.#.#.#####.#########.#######.#####.###.#####.#######.###.#.#.###.#.#####.#.###.#.###.#########.#
#.#.......#...#...#.....#.#.#...#...#.#...#.....#.#.#...#.#.#...#.#.......#.#.......#...#.......#.........#.#...#.#...#.#.#.#...#.....#.#...#...#.....#
#.#.#######.###.###.###.#.###.###.###.###.#.#####.#.#.###.###.#.#.#.#######.#.#####.#.#.#######.#.#######.#.#.###.###.#.#.#.#.###########.###.#.#.#####
#.#.#.........#...#.#...#...#.#...#...#...#...#.#...#...#.#...#.#.#.#.....#.#.#...#.#.#.#.......#.....#...#...#.#...#...#.#...#...........#.#.#.#.#...#
#.#.#.#######.###.###.#####.#.#####.#####.###.#.###.###.#.#.###.#.#.#.###.#.#.#.#.#.#.#.#.#############.#######.#.#.###.#.###.#####.###.###.#.#.#.#.#.#
#...#.#.........#...#.....#.#.....#.....#...#.#.......#.#.#.#.....#.#.#.#...#...#.#...#.#.#.......#...#.#.....#...#.....#...#.#...#.#...#.....#...#.#.#
#######.###.#######.###.#.#.#####.#####.#####.#.#######.#.#.#.#####.#.#.#####.###.#######.#.###.#.#.#.#.#.###.#########.###.#.#.#.#.#.#####.#########.#
#.#.....#...#.....#...#.#.#.....#.....#.......#.#...#...#.#.#.#...#...#.....#...#.....#...#.#...#...#...#...#.........#.#.#.#...#.#.#.....#...#.......#
#.#.#.#######.#.#.###.#.#.#####.#.###.#########.#.#.#.###.#.###.#.###.###.#.#######.#.#.###.#.###.#########.#########.#.#.#.#####.#.#####.###.#.#####.#
#.#.#.#.......#.#.#.#.#.#.#...#...#.......#.....#.#.#.#...#.....#...#...#.#.......#.#.....#.#.#...#...#.....#.#.......#...#...#.#.#...#...#...#.#...#.#
#.#.#.#.#######.#.#.#.###.#.#.###########.###.###.#.#.#.#####.#####.###.#.#######.#######.#.#.#####.#.#.#####.#.#############.#.#.#.###.###.###.#.#.#.#
#...#...#.#...#.#...#...#...#.......#...#...#.....#.#.#.....#.....#.#...#.#.....#.......#.#.#.#...#.#...#.#.....#...........#.#...#.#...#.#...#.#.#.#.#
#.#######.#.#.#.#######.#.#########.#.#.###.#.#######.#####.#####.#.###.#.#####.#######.#.###.#.#.#.#####.#.#######.#######.#.#.###.#.###.###.#.#.#.###
#.#.......#.#.#.....#...#.#.......#.#.#...#.#.#.......#.#...#.....#...#...#...#...#.....#...#.#.#...#.....#.#.......#.....#...#...#.#...#.#...#.#.#...#
#.###.#.###.#.#####.#.###.#.#.#####.#.###.#.#.#.#######.#.#########.#.#####.#.#.#.#.#######.#.#.#######.#.#.#.#######.###.#######.#.###.#.#.###.#.###.#
#...#.#.#...#.#...#.#.#.....#.#.....#.#.#...#.#.....#...#...#.....#.#.......#.#.#.#.#.........#...#.....#.#.#...#.....#.........#.#...#.#...#.....#...#
###.###.#.###.#.#.#.#.#########.#####.#.#########.#.#.#.###.#.###.###.#######.#.#.#.#####.#######.###.###.#.#.#.###.###########.#.###.#.#.###.#####.###
#.#.#...#...#...#...#.#.......#.....#...#.......#.#.#.#...#...#.#...#.#...#...#.#.#.#...#.#.......#...#...#.#.#...#.....#.......#...#.#.#...#.....#...#
#.#.#.#.###.#########.#.#####.#####.###.###.###.#.#.###.#######.###.#.#.###.#####.#.#.#.###.#######.#####.#.#####.#####.#.#########.###.###.#########.#
#...#.#.#.#...#.....#...#.#...#.....#.#.....#.#.#.#...#.......#.....#...#...#.....#.#.#.....#.......#...#.#.....#...#...#.#.......#.#...#.#.#...#...#.#
#.###.#.#.###.#.###.#####.#.###.#####.#######.#.#####.#.###.###.#########.###.#.###.#.#######.###.###.#.#######.###.#.#####.#####.#.#.###.#.#.#.#.#.#.#
#.....#.....#.....#.............#.....................#...#...............#...#.......#.........#.....#.............#...........#.....#.......#...#....
######################################################################################################################################################.