.####################
....#.......#...#...#
###.#.#.###.#.#.###.#
#.#.#.#.#...#.#.#...#
#.#.###.#.###.#.#.#.#
#...#...#.#...#.#.#.#
#.###.###.#.#.#.#.###
#.....#...#.#.#.#...#
#######.###.#.#.###.#
#.....#.#...#.#.....#
#.#####.#####.#####.#
#.......#.....#.....#
#.#######.###########
#.#...........#.....#
#.#####.#####.#.###.#
#.....#.#...#.....#.#
#####.#.#.#.#####.#.#
#.#...#.#.#.#...#.#.#
#.#.#####.#.#.#.###.#
#.........#...#......
####################.