.####################################################################################################
......#...............#...............#...#.................#.#.............#.......#...#...........#
#####.#.###.###########.###.#########.###.#.#############.#.#.#.#.#########.#####.#.###.#.#######.#.#
#...#.#...#.......#.....#...#.......#...#.#.#...#...#.....#.#.#.#.........#.......#...#.........#.#.#
#.#.#.###.#######.#.#####.#########.###.#.#.#.#.#.#.#.#####.#.#.#########.###########.#########.#.#.#
#.#...#.#...#...#...#...#.........#...#.#.....#.#.#...#...#.#.#.....#...#...#.......#.......#...#.#.#
#.#####.###.###.#####.###########.#.###.#########.#####.#.#.#.#####.#.#.#.#.#####.#.#######.#.###.###
#...#.........#.....#.........#...#.#...#.......#.#.#...#.#.#.......#.#.#.#...#...#.#.....#.#...#...#
###.#########.#.###.#.#.#####.#.###.#.###.#####.#.#.#.###.#.#######.#.#.#.###.#.#####.#.###.###.###.#
#.#.........#.#.#...#.#.....#.#.#.....#...#...#.#.#...#.#.#.......#.#.#.#.#...#.#...#.#.#...#.....#.#
#.#########.#.###.###.#####.###.#####.###.###.#.#.#.###.#.#######.###.#.###.###.#.#.#.#.#.###.#####.#
#.....#...#.#...#.....#...#.#...#...#.....#...#.#.#.....#...#...#.....#.#...#...#.#...#.#.#...#...#.#
#.#####.#.#.###.#.#####.#.#.#.###.#.#######.###.#.#####.###.#.#.#######.#.###.#.#.#####.#.#####.#.#.#
#.......#...#...#.#...#.#...#.....#.....#.....#.#.#.#.....#...#.......#...#...#.#.#...#.#.....#.#.#.#
#.#############.###.#.#.###.###########.#####.#.#.#.#.#######.###.#########.#.###.#.#.#.#####.#.#.#.#
#.#...........#.....#...#...#.......#...#...#.#...#.#.#.#...#...#.#.....#...#...#.#.#.#.......#.#.#.#
#.#.###.#####.###########.###.#.###.#.###.#.#.#####.#.#.#.#.#####.#.###.#.#####.#.###.#########.#.#.#
#.#...#.#...#.....#.....#...#.#...#.#.....#.#.#.........#.#.....#.#.#...#.#...#.#...#.#.....#...#...#
#.#####.#.#######.#.#.#####.#####.#########.#.#.#########.#####.#.#.#.###.#.###.###.#.#.#.###.#.#####
#.#.....#.........#.#.....#...#...#.........#.#.#.........#.....#...#.#...#.#...#...#...#.#...#.....#
#.#.#####.#########.###.#.###.#.#.#.#########.#.#.#########.#####.###.#.###.#.###.#######.#.#######.#
#.#.#...#.......#.....#.#...#...#.#.....#.....#.#.#.....#...#.....#.#.#.#...#.#...#.....#.........#.#
#.#.#.#########.#####.#.###.#####.#####.###.#.#.#.###.###.###.#####.#.#.#.#.#.#.###.###.###########.#
#...#.#...#...#...#...#.#.......#.....#.#...#.#.#.#...#...#...#.....#.....#.#.#.#.....#.....#...#...#
#####.#.#.#.#.###.###.#.#.#####.#####.#.#.#####.#.#.###.###.#######.#########.#.###.#.#####.#.#.#.#.#
#.......#.#.#...#...#.#.#.#...#.#.....#.#.#.....#.#.#...#...........#...#.....#...#.#.#.......#...#.#
#.#######.#.###.###.#.#.###.#.###.#####.#.#.#####.#.#.#######.#######.#.#.#######.###.#############.#
#.#.#.....#.#.#...#.#.#.....#.#...#.#...#.#.#.....#.#.......#.#.......#.#.......#...#.#.....#.#.....#
#.#.#.###.#.#.###.#.#.#######.#.###.#.###.#.#.#####.#######.###.#######.#####.#.###.#.#.###.#.#.#####
#...#...#.#.....#...#.#.....#.......#.#.....#.#...........#.........#.#.#...#.#.#...#.#.#.#.#.#.....#
###.###.#######.#######.###.#########.#######.#.###################.#.#.#.#.#.###.###.#.#.#.#.#####.#
#.....#.......#.#.....#...#...#.......#.......#.#.................#.#.#.#.#.#...#.#...#...#.#.....#.#
#.#####.#.###.#.###.#.#.#.###.#.#.#####.#######.#.###############.#.#.#.#.#.###.#.#.#####.#.#.#.###.#
#.#...#.#.#...#.....#.#.#...#.#.#.#.............#.....#.......#...#.#.#...#...#.#.#.#.....#.#.#.#...#
#.#.#.###.###########.#.###.#.#.###.#################.#.#.#####.###.#.#####.#.#.#.#.#.#####.#.###.###
#.#.#...#.........#...#.#.#.#...#...#...#.............#.#.........#...#...#.#.#...#...#.....#.#...#.#
#.#.###.#.###.#####.###.#.#.###.#.#####.#.#.###########.#########.#####.#.###.#.###.###.#####.#.###.#
#.#.#.#.#...#.....#.#.#...#.#...#.#.....#.#.#.......#...#.......#.#.....#.....#.#...#...#...........#
###.#.#.###.#####.#.#.###.#.#####.###.#.#.###.#####.#####.#####.#.#.###########.#.###.###.#########.#
#...#.#.#.....#...#.#...#.#.......#...#.#...#.....#.........#...#.#...#.....#.#.#...#.#.#.#.....#.#.#
#.###.#.###.###.#.#.#.#.#.#########.#####.#.#####.###########.###.###.#.###.#.#.###.#.#.#.#.###.#.#.#
#.#...#...#.#...#.#.#.#.#.#.........#...#.#.....#.....#.#.....#.#.....#.#...#.....#.#.#...#.#.#.#.#.#
#.###.###.###.###.#.#.#.#.#.###.#.###.#.###.###.#####.#.#.#####.#####.#.#.#######.###.#.###.#.#.#.#.#
#...#.....#...#...#.#.#...#.#...#.#...#.#...#...#.....#.#.....#.......#.#...#...#.....#...#...#.#.#.#
###.#.#####.#######.#.#####.#.###.#.###.#.#######.#####.#####.#######.#.###.#.#.#########.###.#.#.#.#
#...#.......#.......#.#.#...#...#.#...#.#.....#...#.........#.......#.#...#...#.....#...#.#...#.#...#
#.#########.#.#######.#.#.#####.#.###.#.#####.#.###.#######.#######.#####.#########.#.#.#.#.###.#####
#.#.......#.#.#.......#.#.....#.#...#.#.#.....#.#...#.......#.....#.....#.......#.#...#.#.#...#.....#
#.#.#####.###.#.#######.#.#####.###.#.#.#.###.#.#####.#####.#####.#####.#######.#.#####.#####.#####.#
#.#...#.#.....#.#...#.....#.....#.#.#.#...#.#.#...#...#.....#.........#.......#.#...#...#...#.#...#.#
#.###.#.#######.###.#.#####.#####.#.#.#####.#.###.#.###.#####.#########.#.#####.###.#.#.#.#.#.#.#.#.#
#...#.#.#.....#.#...#.#.....#.......#.#...#...#.#...#.#...#...#.....#...#.#...#.....#.#.#.#...#.#.#.#
#.###.#.#.###.#.#.###.#.#####.#######.###.#.###.#####.###.#.#.#.###.#.###.#.#.#####.#.#.#.#####.###.#
#.#...#...#.#...#.....#.#.....#.#.....#...#.#...#...........#.#.#.#...#...#.#...#...#.#.#.#.......#.#
#.#.###.###.#####.#####.#.#####.#.#####.#.#.#.###.###########.#.#.#####.###.###.#.###.#.#.#.#####.#.#
#...#.#.#.#...#...#...#.#.#.....#.#.....#.#...#.....#.......#.#.#.....#.#.#...#.#...#.#.#.#.#...#.#.#
#.###.#.#.#.#.#.###.#.#.#.#.###.#.###.#####.###.#####.#####.#.#.#.#.#.#.#.###.#.###.#.###.#.###.#.#.#
#.#...#.#...#...#.#.#...#.#.#...#...#...#...#.....#...#...#.#.#.#.#.#.#.#...#.#.....#.#...#.....#.#.#
#.#.#.#.#####.###.#.#####.###.#.###.#.#.#.###.#####.###.#.#.###.#.#.#.#.#.###.#######.#.#########.#.#
#.#.#...#...#.#...#...#...#...#...#.#.#...#...#.....#.#.#.#.#...#.#.#.#...#.....#...#.#...#.......#.#
#.###.###.#.#.###.###.#.###.#####.#.#.#####.###.#####.#.#.#.#.#####.#.#.###.#####.#.#.###.#.#####.#.#
#...#.....#.#.#...#...#.#.......#.#.#.#.......#...#.....#.....#.....#.#.#...#.....#.#.#...#...#...#.#
###.#######.#.#.#.#.###.#.#####.#.#.###.#########.#############.#####.#.#.###.#####.#.#.#####.#.###.#
#.#.#.#.....#...#.#...#.#.....#.#.#...#.#...#.....#...........#.#.....#.#.#.#.#...#...#.......#.#...#
#.#.#.#.#########.###.#.#######.#####.#.#.#.#.###.#.#########.#.#.#####.#.#.#.#.#.#############.#.###
#.#.#...#.....#...#...#...#...#...#...#.#.#.#.#.#.#...#...#...#.#.....#.#...#...#.......#.....#.#...#
#.#.#.#####.#.#####.#####.#.#.###.#.###.#.###.#.#.###.#.#.#.###.#######.###.#########.#.#.#.###.###.#
#.#.#.....#.#.......#...#...#.....#.....#.#...#...#.#.#.#.#...#.........#.#.#.....#.#.#...#.#.....#.#
#.#.#####.#.#########.#.#########.#####.#.#.###.###.#.#.#####.#######.###.#.#.#.#.#.#.#.#####.#####.#
#...#...#.#.....#...#.#.....#.....#...#...#.#...#...#...#.....#.....#.....#.#.#.#...#.#.#.......#...#
#.###.#.#.#####.#.#.###.#####.#####.#.#####.#.###.#.###.#.#####.###.#####.#.###.#.###.#.#.#######.#.#
#...#.#.#.#.....#.#.....#.....#...#.#.#...#.#.....#...#.#.#.......#.#...#.#.....#.#...#.#...#.....#.#
###.#.###.#.#####.#####.#.#######.#.#.#.#.#.###########.#.#.#######.#.#.###.#####.#.#####.###.#####.#
#.#.#.......#.....#...#.#.#.......#.#...#.#.............#.#.....#...#.#...#.#...#.#.......#...#.....#
#.#.###.#####.###.#.#.###.#.#.#####.#####.#####.#########.#####.#.###.###.#.#.#.###.#######.#####.###
#.#...#.#...#...#.#.#.....#.#.#...#...#.#.....#.........#.......#.....#.#...#.#...#.#.....#.....#.#.#
#.###.#.#.#.#####.#.#######.#.#.#.#.#.#.#####.#######.#########.#######.#####.###.###.###.#.###.#.#.#
#...#.#.#.#.#...#.......#...#.#.#.#.#.#.....#.....#...#.......#...#.....#.....#.......#...#.#...#.#.#
#.#.#.###.#.#.#.#######.#.###.#.#.#.#.#.#.#.#####.#.###.#####.###.#.###.#.#############.#####.###.#.#
#.#.#.....#...#...#.......#...#.#.#.#.#.#.#...#...#.#...#...#.#.....#...#.......#.......#.....#...#.#
###.#############.#.###########.#.###.###.###.#.###.#.###.#.#.#.#####.#########.#.#######.#####.###.#
#.......#...#...#.#.#...#...#...#.....#...#...#.#...#.#...#...#.#...#.#.....#...#.......#...#.#.#...#
#.#######.#.#.#.#.#.#.#.#.#.#.#########.###.###.#####.#.#########.#.#.#.###.#.#########.###.#.#.#.#.#
#.#.......#...#...#.#.#.#.#...#.#.........#...#.......#.#.........#.#...#...#.#.......#.#...#.....#.#
#.#.###############.#.#.#.#####.#.#######.###.#########.#.#####.###.#####.###.#.#.#.###.#.###########
#.#.#...#...#.......#.#.#.#...#...#.....#.#.#...#.....#.#.#.....#...#...#...#.#.#.#.#...#.......#...#
#.#.#.#.#.#.#.#########.#.#.###.###.###.#.#.###.###.#.#.###.#####.###.#####.#.#.#.###.###.#####.#.#.#
#.#...#...#.#...........#.#.#...#...#...#.#.........#.#.#...#...#.#.#.....#.#.#.#.....#.....#.#...#.#
#.#########.###########.#.#.#.#####.#.###.###########.#.#.#####.#.#.#.###.#.#.#####.#######.#.#####.#
#.......#...#...#.....#.#.#.#.....#.#...#.....#.......#...#.....#.#.....#...#.....#.....#.......#...#
#####.#.#.###.###.###.#.#.#.#####.#.###.#####.#############.#.###.#####.#########.#####.#########.#.#
#.....#.#.#.........#...#.#.....#.#.#...#...#.....#.......#.#.....#...#...#.....#.....#...........#.#
#.#######.#.#########.###.#.###.#.###.#.#.#.#####.#.###.###.#######.#.#####.###.#####.#############.#
#.....#...#.#...#...#.#...#...#.#.#...#...#.#...#.#...#.....#.....#.#.......#.#.....#.....#.......#.#
#.###.#.#####.#.#.#.###.#######.#.#.#######.#.#.#.###.#######.###.#.#########.#####.#####.#.###.###.#
#.#.#...#.....#...#.....#.......#...#.#.....#.#...#...#.......#.#...#...........#.#.#.....#.#.#.....#
#.#.#####.#.#############.#.###.#####.#.#####.###.#.###.#######.#####.###.#####.#.#.#.#####.#.#######
#.#.....#.#...#.#.......#.#...#.#.......#...#.#...#.#...#.....#.....#...#.....#...#.#.....#.#.......#
#.###.#.#####.#.#.#####.#.###.###.#########.#.#####.###.#.#####.###.###.#####.#####.#####.#.#.#####.#
#.....#.......#.......#.....#...............#...........#.........#.........#.............#...#......
####################################################################################################.