.########################################
......#.......#...#...............#.....#
#####.#.#.###.#.#.###.###########.#.###.#
#.....#.#...#...#...#.#.......#...#.#...#
#.#######.#.#######.#.#.#.#####.###.#.###
#.#.....#.#.#.....#...#.#.....#.#...#...#
#.#.###.#.#.#####.#####.#####.#.#.#####.#
#.#...#.#.#.#.........#...#.#...#.#.....#
#.###.#.###.#.#####.#####.#.#####.#.###.#
#...#.#.....#.#.....#.....#.....#.#.#.#.#
###.#.#######.#####.#.#####.###.###.#.#.#
#.#...#.#.........#.#.#.......#.....#...#
#.#####.#.#######.###.#.#####.#######.###
#.....#...#.....#.#...#.#.....#.#.....#.#
#.###.#.###.#.###.#.###.#.#####.#.#####.#
#.#.#...#...#.#...#...#.#.#.....#...#...#
#.#.#########.#.#####.#.#.#####.###.###.#
#.#.......#...#...#...#.#.#.....#.#.....#
#.###.#.#.#.#####.#.###.#.#.###.#.#####.#
#...#.#.#.#.#...#.#...#.#.#...#.......#.#
###.###.#.#.#.#.#.###.###.#.#.#######.#.#
#.#...#.#.#.#.#.....#.....#.#...#.....#.#
#.###.#.#.#.#.###.#############.#.#####.#
#...#...#...#...#.#.....#.......#.#...#.#
#.#########.###.###.#.#.###.#####.#.###.#
#.......#.....#.#...#.#.....#...#...#...#
#.#.#.###.#####.#.###.#######.#####.#.###
#.#.#.#.....#...#.#...#.....#.......#.#.#
#.#.###.#####.#.#.#.###.###.#.#######.#.#
#.#.....#.....#.#.#...#...#.........#...#
#.#######.#####.#.###.###.#######.#####.#
#...#...#.....#.#...#.#...#.....#.#.....#
###.#.#.#####.#####.#.#####.###.#.#.#####
#.#...#.#...#.....#.#.....#...#.#.#...#.#
#.#####.#.#####.###.#####.###.#.#####.#.#
#.......#.#.....#...#...#...#.#.....#.#.#
#.#######.#.#####.#####.###.#.#####.#.#.#
#.#.......#...#...#.......#.#.#.#...#.#.#
#.#######.###.#.###.#####.#.#.#.#.###.#.#
#...........#.......#.....#.....#........
########################################.