.####################################################################################################
..#.....#...........#...#.......#...............#.....#...#.....#.......#...........#.........#.....#
#.#.###.#.#######.#.#.#.#.#.###.#.#############.###.###.#.#.#.#.#.#####.#.#.#######.###.#####.#.###.#
#.#.#...#.....#...#...#.#.#.#.#.#.#...#.......#...#.....#...#.#...#...#.#.#...#...#...#.....#.#...#.#
#.#.#.#######.#.#######.###.#.#.#.#.#.#.#####.###.#.#######.#.#######.#.#####.#.#####.#####.#.###.#.#
#.#.#.#...#...#...#...#.....#.....#.#.#.....#...#.#.#.....#.#.#.....#...#...#.#.....#.....#.#.#...#.#
#.#.#.#.#.#.#####.#.#.#.###########.#######.#.#.#.###.###.###.#.###.###.#.#.#.#.#.#######.#.#.###.#.#
#.#.#...#...#.....#.#.#.#.......#.#...#.....#.#.#...#.#.#...#.....#...#...#...#.#.....#...#.#...#.#.#
#.#.#########.###.#.#.###.#####.#.#.#.#.#####.#.###.#.#.###.#####.###.#############.###.###.###.###.#
#.#...#...#...#...#.#.....#.....#...#...#...#.#.#.#...#...#...#.....#.....#.........#...#...#...#...#
#.###.#.#.#.#######.#####.#.#####.#######.#.#.#.#.#####.#####.#####.#####.###.#####.#.###.###.###.###
#.#...#.#.#.........#...#.#.#...#.#.......#.#.#.......#.....#.....#.#...#...#...#.#.#...#...#...#...#
#.#####.#.#.#########.#.###.#.#.#.###.#.#####.#####.###.###.#####.#.###.###.#.#.#.#.###.#.#.###.###.#
#.......#.#.#.......#.#.....#.#.#...#.#.....#.....#.#...#.....#...#.......#.#.#.#.....#.#.#...#.....#
#########.#.###.###.#.#########.###.###.###.#####.###.###.#####.###########.#.#.#######.#####.#####.#
#...#.....#.....#...#.#...#.....#.#...#...#...#...#...#.#.....#...........#.#.#.#.......#.....#.....#
#.#.#.###########.###.###.#.#.#.#.###.###.###.#.#.#.###.#####.###########.#.#.#.#.#######.###########
#.#.#...#.....#.....#.#...#.#.#...#...#.....#.#.#.#.......#.#...........#...#.#...#...#.............#
#.#####.###.#.#.#####.#.#.#.#.#####.#########.#.#.#######.#.#####.###########.#######.#.#########.#.#
#.#...#...#.#.....#...#.#.#.#.......#...#...#.#.#...#...........#.....#.......#...#...#...#.....#.#.#
#.#.#.###.#########.###.###.#########.#.#.#.#.#.#####.###############.#.#######.#.#.#.###.#.###.#.#.#
#...#...#...#.....#.#.#...#.#...#.....#...#.#.#.#...#...#.........#...#.#.......#...#.#...#.#.#.#.#.#
#.###.#####.#.###.#.#.#.#.#.#.#.#.#########.#.#.#.#.#.###.#######.#.#.#.#.#############.###.#.#.###.#
#...#.....#...#.#...#.#.#...#.#.#.#...#.......#.#.#...#...#...#.....#.#.#.#...........#...#.#...#...#
#########.#####.#####.#.#####.#.#.#.###.#######.#.#####.#.#.#.#########.#.#.#####.###.#.###.#.###.#.#
#...#.............#...#.#.....#.#.#...#...#.#...#.#.#...#.#.#.......#...#...#...#...#...#...#.#...#.#
#.#.#.#####.#######.#.#.#.#####.#.###.###.#.#.###.#.#.###.#.#######.#.#####.#.#.#######.#.###.#.#.#.#
#.#...#.....#.......#.#...#...#.#...#...#...#.....#.#...#.#.......#...#...#.#.#...#...#.#...#.#.#.#.#
#.###.#####.#.#######.#####.###.###.#.#####.#######.###.#########.#####.#.#.#.###.#.#.#####.#.###.#.#
#...#.#...#.#...#.....#...#.....#...#.#...#.#.......#.#.......#...#.....#.#.#.#...#.#.....#.#.....#.#
###.###.#.###.###.###.#.#.#.#####.###.#.#.#.#.#.###.#.#####.#.#.#######.#.###.#.###.#####.#.#######.#
#...#...#.....#...#.#.#.#.#.#.....#...#.#...#.#...#...#...#.#.#.....#...#.....#.#...#...#.#.....#...#
#.#.#.#########.###.#.#.###.#.#######.#.#########.###.#.#.#.#.#####.#.#########.#.#####.#.#####.###.#
#.#.#.#.......#...#.....#...#.#.......#.........#.#...#.#...#.....#.#.....#.....#.#.....#.....#...#.#
#.###.###.#.#####.#.#####.###.#.#.#############.#.#.###.#####.#####.#.###.#.#####.###.#######.###.#.#
#.#...#...#.#.....#...#...#...#.#.........#...#...#...#.#...#.#.....#.#...#...#.....#.#.....#.....#.#
#.#.###.#####.#.#####.#.###.#.#######.###.#.#.###.#####.#.#.#.#.#####.#.#####.#.###.#.#.###.#######.#
#.......#...#.#.#...#.#.#...#.#.....#...#...#.....#...#.#.#.#.#...#...#.#.....#.#.#.#...#.#.........#
#.#######.#.#.#.#.#.#.#.#.###.#.###.#######.#######.#.#.#.#.#.###.#####.#.#####.#.#.###.#.###########
#...#...#.#...#.#.#.#.#.#.#...#.#...#.....#...#...#.#...#.#...#...#.....#.#.#...#.#...#.....#.......#
#####.#.#.#####.#.#.#.#.#.#.###.#.###.###.#####.#.#.#.#######.#.###.#####.#.#.###.###.#####.#####.###
#.....#...#...#.#.#.#.#.#.#.#.#.#.....#.........#.#.#.#.....#.#...#...#...#...#.#...#.#...#.....#...#
#.#####.###.#.###.#.###.#.#.#.#.#################.#.#.#.###.#.###.#.#.#.###.###.#.#.#.#.#.#####.###.#
#.#...#.#...#.....#...#.#.#.#.#.#.......#...#...#.#.#.#.#...#.#...#.#.#...#.#.....#.#.#.#.#.#...#...#
#.#.#.#.#.###########.#.#.#.#.#.#.#####.#.#.#.###.#.###.#.#####.#####.###.#.#######.#.#.#.#.#.###.#.#
#.#.#.#.#.#.....#...#.#.#.#...#...#...#...#.#.#.....#...#.#.....#.....#...#.........#.#.#...#.#...#.#
#.#.#.###.#.###.#.#.#.#.#.###.#####.#.#####.#.#.#####.###.#.#######.#####.#.#######.#.#.#####.#.#####
#...#.....#...#...#.#.#...#.#.....#.#.......#...#...#...#.#.#.......#...#.#.#.....#.#.#.......#.....#
#.###########.#####.#.#####.###.###.#########.###.#.###.#.#.#.#.###.#.#.#.#.#.###.###.#.###########.#
#.....#.....#.#.....#.........#.#...#.....#...#...#...#.#.#.#.#...#.#.#.#.#.#.#.#...#.#...#.........#
#####.###.###.#.#########.#####.#.###.###.#.###.#####.#.#.#.#.###.###.#.#.#.#.#.###.#.###.#.#.#####.#
#.#...#...#...#.........#.......#.#...#.#.#.#...#...#...#...#...#.....#.#.#.#.#...#...#.#.#.#.#.....#
#.#.###.###.###########.#########.#.###.#.###.#####.###################.#.###.#.#.#####.#.###.#.#####
#.#.#...#...#.......#...#.......#...#...#.....#...#.....................#.....#.#...#...#.....#.....#
#.#.#.#.#.###.#####.#.###.###.#######.#.#######.#.#####.#######################.#.#.#.#.###########.#
#.#.#.#...#...#.....#...#.#.#.....#...#.....#...#...#...#.#.......#.......#.....#.#...#.#.....#...#.#
#.#.#####.#.###.#######.#.#.#####.#.#####.#.###.###.#.###.#.#.#####.###.###.#####.#####.#.###.###.#.#
#.#.....#...#...#.....#...#...#...#...#...#.....#.#...#...#.#.....#.#.#.....#...#.#...#...#.......#.#
#.#####.###.#####.###.#.#####.#.#####.#.#########.#####.#.#.#####.#.#.#######.#.#.#.###.###########.#
#.......#...#.....#.#.#.#.....#.......#.....#.........#.#...#...#...#.....#...#...#...#.#.........#.#
#.###########.#####.#.#.#.#.#.#########.###.#####.#####.#######.#####.###.#.#######.#.#.#.#######.#.#
#.#...........#.....#.#.#.#.#.....#...#...#...#...#.....#...........#...#.#...#.....#.#.#.#...#...#.#
#.#.###.###########.#.#.###.#####.#.#.#######.#.###.#####.#########.###.#.###.#.#####.#.#.#.#.#.###.#
#.#...#.....#.......#.#.....#...#.#.#.......#.#.#...#.........#...#.....#...#.#.#.....#.#.#.#.#.....#
#.#########.#.#####.#.###.###.#.#.#.#######.#.#.#.###########.#.#########.###.#.#.#####.#.#.#########
#...........#.....#.#...#.#...#.#.#.#.....#.#.#.#.............#...........#...#.#.......#.#.........#
#################.#####.###.###.###.#.###.#.#.#.#.#############.###########.###.#########.#.#######.#
#...............#.#.....#...#...#...#.#.#.....#...#.........#.#.....#.....#.#...#.........#...#...#.#
#.#####.#######.#.#.#####.#####.#.###.#.###########.#######.#.#####.#####.#.#.###.###########.###.#.#
#.#.....#.....#.#.#.#...#.....#...#.#.#.....#.......#.......#...#.........#.#...#...#...#.........#.#
###.#####.#.###.#.#.#.#.#.###.#####.#.#####.#.#######.#######.#.#.#########.###.###.#.#.#.#########.#
#...#.....#.......#...#.#.#...#...#.#.....#.#.#.#.....#...#...#.#.#.......#.#...#...#.#...#.#...#...#
#.###############.#####.#.#.###.#.#.#####.#.#.#.#.#####.###.###.#.#.#####.#.#####.#######.#.#.#.#.#.#
#.......#.....#...#...#.#.#...#.#.#.......#.#.#.#.....#.......#...#.#.#...#.....#.#.....#...#.#...#.#
#.#####.#.###.#.###.###.#.###.#.#.#.#######.#.#.#####.#.###########.#.#.###.###.#.#.###.#.###.#####.#
#.#.....#.#...#.#...#...#.#...#.#.#...#.....#...#...#.#.#.........#...#.#.#...#.#...#.#.#.#...#...#.#
#.#.#####.#.###.###.#.#####.###.#.###.#.###.###.###.#.###.#######.###.#.#.###.#.#####.#.###.###.###.#
#.#.....#.#.#.......#.#.....#...#...#.#...#...#...#.#.....#.....#.....#.#...#.#.......#...#...#...#.#
#.#####.#.#.#########.#.###.#.#####.#.###.###.###.#.#######.###.#######.#.#.#.#####.#####.###.#.#.#.#
#.#...#...#.........#.#...#.#.#...#.#.....#...#...#.......#.#.....#...#.#.#.......#.#...#.....#.#...#
#.#.#.#############.#.###.###.#.#.#.#######.###.#####.###.###.#####.#.#.#.#########.#.#.#######.#####
#...#.....#...#...#...#...#...#.#.#.#.....#...#.#.....#...#...#.....#...#.#.....#...#.#.......#.#...#
#########.#.###.#.#####.###.###.#.#.#.###.#####.#.#######.#.#.#.#########.#.###.#.#.#.#####.###.#.#.#
#...#.....#.....#.#.........#...#.#.#.#...#.......#.....#...#.#...#...#...#...#.#.#.#.#...#.....#.#.#
#.###.#####.#####.#.#########.###.#.#.#.###.#######.###.#######.#.#.#.#####.#.#.#.#.#.#.#.#########.#
#.#...#...#.....#.#...#.......#...#.#.#.#...#.#.....#.#.......#.#...#.#...#.#.#...#.#.#.#.........#.#
#.#.###.#.#.#####.###.#######.#.###.#.#.#.###.#.#####.#######.#######.#.#.###.#####.#.#######.###.#.#
#.#.....#.#.#...#...#.#.....#.#.#...#.#...#...#...#.......#.#.....#...#.#.....#.#...#.......#.#.....#
#.#######.###.#.###.#.#.###.#.#.#.###.#######.###.#.###.#.#.#####.#.###.#.#####.#.#########.#.#####.#
#.#.....#...#.#...#.....#.....#.#.#...#.......#...#...#.#...#...#.#...#.#.#...#.....#...#...#.....#.#
#.#.###.###.#.###.###.#######.###.#.#####.#####.#######.###.#.#.#.#.#.#.###.#.#.#####.#.#.#######.#.#
#...#.#...#.#.#.....#.#...#...#...#.......#.....#.......#...#.#...#.#.#.#...#.#...#...#.#.#.......#.#
#.###.###.#.#.#####.#.#.#.#.###.###.#######.#####.#.#########.#######.#.#.###.#####.###.#.#.#######.#
#.....#.#...#...#...#.#.#.#...#.#...#...#...#...#.#.#.......#.#.......#.#...#.....#.#.#...#.#.....#.#
#####.#.#####.#.###.###.#.#####.#.###.#.#.###.###.#.#.#####.#.###.#####.###.#####.#.#.#####.#.#####.#
#...#...#.....#...#...#.#.....#.....#.#.#...#.....#...#...#...#...#.......#.#.#...#.#.......#.#...#.#
#.#####.#########.###.#.#####.#######.#.###.###.#######.#.#####.###.#.#####.#.#.#.#.#####.#.#.#.#.#.#
#.....#...........#.#.#.#...#.....#...#...#...#.#.......#...#...#...#.#...#.#.#.#.#.....#.#.#...#...#
#.#.###############.#.#.#.#######.#.#####.###.#.###.#######.###.#.#####.#.#.#.#.#######.###.#.#######
#.#.....................#...........#.........#.....#...........#.......#.....#.............#........
####################################################################################################.