.##########
..#.......#
#.###.###.#
#...#.#...#
###.#.#.###
#...#.#...#
#.###.###.#
#.#...#...#
#.#.###.###
#...#......
##########.